one => ore 
ore => are ere ire 
are => ace age ale ape arc ark arm art ate ave awe axe aye ere ire 
ere => eke err eve ewe eye ire 
ire => ice irk 
aye => ace age ale ape ate ave awe axe bye dye eye rye 
ace => act age ale ape ate ave awe axe ice 
age => ago ale ape ate ave awe axe 
ale => all ape ate ave awe axe 
ape => apt ate ave awe axe 
ate => ave awe axe 
ave => awe axe eve 
awe => axe ewe 
arc => ark arm art 
ark => arm art irk 
arm => aim art 
art => act aft apt 
eye => bye dye eke eve ewe rye 
eke => eve ewe 
eve => ewe 
err => ear 
irk => ink 
rye => bye dye roe rue 
bye => bee dye 
dye => die due 
act => aft apt 
all => ail 
apt => aft opt 
aim => aid ail air dim him rim 
aft => oft 
ear => bar car eat far jar mar oar par tar war 
ink => inn 
roe => foe hoe rob rod rot row rue toe woe 
rue => cue due hue rub rug rum run rut sue 
bee => bed beg bet fee lee see wee 
die => did dig dim din dip due lie pie tie vie 
due => cue dub dug hue sue 
ail => aid air nil oil 
opt => oat oft out 
dim => dam did dig din dip him rim 
him => ham hem hid hip his hit hum rim 
rim => ram rib rid rig rip rum 
aid => add air and bid did hid kid lid mid rid 
air => fir sir 
oft => oat off out 
tar => bar car far jar mar oar par tab tag tan tap tau tax war 
bar => bad bag bah ban bas bat bay car far jar mar oar par war 
car => cab can cap cat caw cdr cur far jar mar oar par war 
eat => bat cat fat hat mat oat pat rat sat vat 
far => fag fan fat fir for fur jar mar oar par war 
mar => jar mad man map mat max may oar par war 
par => jar oar pad pal pan pat paw pay per war 
jar => jab jam jaw jay oar war 
oar => oak oat our war 
war => wag wan was wax way 
inn => ion 
toe => foe hoe the tie ton too top tow toy woe 
foe => fee fog for fox hoe woe 
hoe => hog hop hot how hue woe 
woe => wee won woo 
row => bow cow how low mow now raw rob rod rot tow vow 
rob => bob job mob rib rod rot rub sob 
rod => cod god nod pod red rid rot sod 
rot => cot dot got hot jot lot not pot rat rut 
hue => cue hub hug huh hum hut sue 
rub => cub dub hub pub rib rug rum run rut sub tub 
rug => bug dug hug jug mug rag rig rum run rut tug 
cue => cub cup cur cut sue 
rut => but cut gut hut jut nut out put rat rum run 
sue => see she sub sum sun sup 
rum => bum gum hum ram run sum 
run => bun fun gun nun pun ran sun 
beg => bag bed bet big bog bug leg peg 
fee => fed fen few lee see wee 
wee => lee see web wed wet 
bed => bad bet bid bud fed led red wed 
bet => bat bit but get jet let met net pet set wet yet 
lee => led leg let lie see 
see => sea set sew sex she 
tie => lie pie the tin tip tit vie 
lie => lid lip lit pie vie 
pie => pig pin pit vie 
vie => via 
din => bin den did dig dip don fin gin kin pin sin tin win 
dip => did dig hip lip nip rip sip tip 
dig => big did dog dug fig gig jig pig rig wig 
did => bid dad hid kid lid mid rid 
dug => bug dog dub hug jug mug tug 
dub => cub hub pub sub tub 
nil => nip oil 
oat => bat cat fat hat mat oak out pat rat sat vat 
out => but cut gut hut jut nut our put 
dam => dad day ham jam ram 
hip => hap hid his hit hop lip nip rip sip tip 
hit => bit fit hat hid his hot hut kit lit mit pit sit tit wit 
hum => bum gum ham hem hub hug huh hut sum 
hem => gem ham hen her hew hex hey 
ham => had hag hap has hat hay jam ram 
hid => bid had his kid lid mid rid 
his => has 
rip => lip nip rap rib rid rig sip tip 
rib => bib rid rig 
rig => big fig gig jig pig rag rid wig 
rid => bid kid lid mid red 
ram => jam rag ran rap rat raw ray 
bid => bad bib big bin bit bud kid lid mid 
lid => kid lad led lip lit mid 
kid => kin kit mid 
mid => mad mit mix mud 
add => and 
fir => fig fin fit fix for fur sir 
sir => sin sip sit six 
tan => ban can fan man pan ran tab tag tap tau tax ten tin ton van wan 
tap => cap gap hap lap map nap rap sap tab tag tau tax tip top 
tab => cab jab lab tag tau tax tub 
tag => bag fag gag hag lag nag rag sag tau tax tug wag 
tau => tax 
tax => max wax 
bag => bad bah ban bas bat bay big bog bug fag gag hag lag nag rag sag wag 
bay => bad bah ban bas bat boy buy day gay hay jay lay may nay pay ray say way 
ban => bad bah bas bat bin bun can fan man pan ran van wan 
bad => bah bas bat bud dad gad had lad mad pad sad 
bah => bas bat 
bas => bat bus gas has was 
bat => bit but cat fat hat mat pat rat sat vat 
cap => cab can cat caw cop cup gap hap lap map nap rap sap 
cat => cab can caw cot cut fat hat mat pat rat sat vat 
caw => cab can cow jaw law paw raw saw 
can => cab fan man pan ran van wan 
cab => cub jab lab 
cur => cdr cub cup cut fur our 
fat => fag fan fit hat mat pat rat sat vat 
hat => had hag hap has hay hot hut mat pat rat sat vat 
mat => mad man map max may met mit pat rat sat vat 
pat => pad pal pan paw pay pet pit pot put rat sat vat 
rat => rag ran rap raw ray sat vat 
sat => sad sag sap saw say set sit vat 
vat => van 
for => fog fox fur nor 
fan => fag fen fin fun man pan ran van wan 
fag => fig fog gag hag lag nag rag sag wag 
fur => fun our 
man => mad map max may men pan ran van wan 
map => gap hap lap mad max may mop nap rap sap 
may => day gay hay jay lay mad max nay pay ray say way 
mad => dad gad had lad max mud pad sad 
max => mix wax 
pan => pad pal paw pay pen pin pun ran van wan 
pay => day gay hay jay lay nay pad pal paw ply pry ray say way 
pad => dad gad had lad pal paw pod sad 
paw => jaw law pal pew raw saw 
per => her pea peg pen pep pet pew 
jay => day gay hay jab jam jaw joy lay nay ray say way 
jab => jam jaw job lab 
jaw => jam law raw saw 
wan => ran van wag was wax way win won 
wag => gag hag lag nag rag sag was wax way wig 
way => day gay hay lay nay ray say was wax why 
wax => was 
was => gas has 
ion => don non son ton won yon 
too => boo coo ton top tow toy two woo zoo 
two
